                                                                           #*       *%##  
                                                                          *%@#+ +#%@@@@@@ 
                                                                           #@@@@@@@@@@@@  
              %                                                            %@@@@@@@@@@@@  
             @@@%%@@@@%*     *#*                                        *#%@@@@@@@%@@@@@  
            @@@@@@@@@@@@@@% %@@%%                                        %@@@@@@@##       
            @@@@@@@@@@@@@@@@@@#                                           %@@@@@@@        
             @@@@@@@@@@@@@@@@@@#                                         #@@@@@@%         
              @@@@@@@@@@@@@@@@@@@@#                            **##%##%@@@@@@@@@          
               @@@@@@@@@@@@@@@@@@                         *%@@@@@@@@@@@@@@@@@@@@          
                @@@@@@@@@@@@@@@@@@@@@@%%*               *@@@@@@@@@@@@@@@@@@@@@@@          
                   @@@@@@@@@@@@@@@@@@@@@@@@@@@@@@@@@@%@@@@@@@@@@@@@@@@@@@@@@@@@@          
                     @@@@@@@@@@@@@@@@@@@@@@@@@@@@@@@@@@@@@@@@@@@@@@@@@@@@@@@@@@@          
                      @@@@@@@@@@@@@@@@@@@@@@@@@@@@@@@@@@@@@@@@@@@@@@@@@@@@                
                      %@@@@@@@@@@@@@@@@@@@@@@@@@@@@@@@@@@@@@@@@@@@@@@@@@@%                
                       %@@@@@@@@@@@@@@@@@@@@@@@@@@@@@@@@@@@@@@@@@@@@@@%                   
                         @@@@@@@@@@@@@@@@@@@@@@@@@@@@@@@@@@@@@@@                          
                            @@@@@@@@@@@@@@                                                
                            @@@@@@@@@@@@@                                                 
                           @@@@@@@@@@@@                                                   
                          @@@@@@@@@@@@@                                                   
                          @@@@@@@@@@@@                                                    
                         @@@@@@@@@@@@@                                                    
                         @@@@@@@@@@@@%                                                    
                         @@@@@@@@@@@@@                                                    
                            @@@@@@@@@@     


