                                                                 %%    #%@@@
                                                                  @@@@@@@@@@
                 @%             @@@@                             #@@@@@@@@@@
                @@@@@@@@@%#* #@@@@@@@@                         *@@@@@@@*@@% 
                @@@@@@@@@@@@@@@@@@@@@@@                         #@@@@@%     
                 @@@@@@@@@@@@@@@@@@@@@@@@@                      %@@@@%      
                  @@@@@@@@@@@@@@@@@@@@@@@@@%          +#%%@%%@@@@@@@@@      
                   @@@@@@@@@@@@@@@@@@@@@@@@@       #@@@@@@@@@@@@@@@@@       
                  @@@@@@@@@@@@@@@@@@@@@@@@@@@@@@**@@@@@@@@@@@@@@@@@@@       
                   @@@@@@@@@@@@@@@@@@@@@@@@@@@@@@@@@@@@@@@@@@@@@@@@@@       
                   @@@@@@@@@@@@@@@@@@@@@@@@@@@@@@@@@@@@@@@@@@@@@@@          
                   @@@@@@@@@@@@@@@@@@@@@@@@@@@@@@@@@@@@@@@@@@@@@@           
                  @@@@@@@@@@@@@@@@@@@@@@@@@@@@@@@@@@@@@@@@@@@@@@@           
               @@@@@@@@@@@@@@@@@@@@@@@@@@@@@@@@@@@@@@@@@@@@@@@@             
              @@@@@@@@@@@@@@@@@@@@@@@@@@@@@@@@@@@@@@@@@@@@@@@@@@            
             @@@@@@@@@@@@@@@@@@@@@@@@@@@@@@@@@@@@@@@@@@@@@@@@@@@@           
            @@@@@@@@@@@@@@@@@@@@@@@@@@@@@@@@@@@@@@@@@@@@@@@@@@@@@%          
            @@@@@@@@@@@@@@@@@@@@@@@@@@@@@@@@@@@@@@@@@@@@@@@@@@@@@@          
            @@@@@@@@@@@@@@@@@@@@@@@@@@@@@@@@@@@@@@@@@@@@@@@@@@@@            
           %@@@@@@@@@@@@@@@@@@@@@@@@@@@@@@@@@@@@@@@@@@@@     @@             
           @@@@@@@@ @@@@@@@@@@@@@@@@@@@@@@@@@@@@@@@@@@@                     
           @@@@@@@@@@@@@@@@@@@@@@@@@@@@@@@          %                       
           @@@@@@@@@@@@@@@@@@@@@@@@@@@@@                                    
          %@@@@@@@@@@@@@@@@@@@@@ @@@@@@@                                    
            %@@@@@@@@@@@@@@@@@@%      @@                                    
              @@@@@@@@@@@@@@@@@@@                                           
               @@@@@@@@@@@@@@@@@@%                                          
                        @@@@@@@@@@@                                         
                         @@@@@@@@% @                                        
                           @@@@@@@               


