                    #@#+                                                   ***                    
                    %@@@@%+                                        +**#%%@@@@@@@@@@%@@  #         
                  %@@@@@+                                        %@@@@@@@@@@@@@@@@@@@@@@@%        
                  @@@@@%++ *%%%%*+++                          *%@@@@@@@@@@@@@@@@@@@@@@@@@@@%      
                   @@@@@@@@@@@@@@@@@@@%**++#@@*++++          *@@@@@@@@@@@@@@@@@@@@@@@@@@@@@@@@@@@%
                    @@@@@@@@@@@@@@@@@@@@@@@@@@@@@@@@@@@#*#%@@@@@@@@@@@@@@@@@@@@@@@@@@@@@@@@@@@@@@#
                    @@@@@@@@@@@@@@@@@@@@@@@@@@@@@@@@@@@@@@@@@@@@@@@@@@@@@@@@@@@@@@@@@@@@@@@@@@@@@@
                     @@@@@@@@@@@@@@@@@@@@@@@@@@@@@@@@@@@@@@@@@@@@@@@@@@@@@@@@@@@@@@@@@@@@@@@@@@@@ 
                       @@@@@@@@@@@@@@@@@@@@@@@@@@@@@@@@@@@@@@@@@@@@@@@@@@@@@@@@@@@@@@@@@@@@       
                        @@@@@@@@@@@@@@@@@@@@@@@@@@@@@@@@@@@@@@@@@@@@@@@@@@@@@@@@@@@@@@@@@@#       
                        %@@@@@@@@@@@@@@@@@@@@@@@@@@@@@@@@@@@@@@@@@@@@@@@@@@@@@@@@@@@@@@@@%        
                  #%%%%@@@@@@@@@@@@@@@@@@@@@@@@@@@@@@@@@@@@@@@@@@@@@@@@@@@@@@@@@@@@@@@@@#         
                  @@@@@@@@@@@@@@@@@@@@@@@@@@@@@@@@@@@@@@@@@@@@@@@@@@@@@@@@@@@@@@@@@@@@@@%         
                 @@@@@@@@@@@@@@@@@@@@@@@@@@@@@@@@@@@@@@@@@@@@@@@@@@@@@@@@@@@@@@@@@@@@@@@%         
                 %@@@@@@@@@@@@@@@@@@@@@@@@@@@@@@@@@@@@@@@@@@@@@@@@@@@@@@@@@@@@@@@@@@@@#*          
                %@@@@@@@@@@@@@@@@@@@@@@@@@@@@@@@@@@@@@@@@@@@@@@@@@@@@@@@@@@@@@@@@@@@@#            
               %@@@@@@@@@@@@@@@@@@@@@@@@@@@@@@@@@@@@@@@@@@@@@@@@@@@@@@@@@@@@@@@@@@@###            
                #@@@@@@@@@@@@@@@@@@@@@@@@@@@@@@@@@@@@@@@@@@@@@@@@@@@@@@@@@@@@@@@@@@@@@#           
                 %@@@@@@@@@@@@@@@@@@@@@@@@@@@@@@@@@@@@@@@@@@@@@@@@@@@@@@@@@@@@@@@@@@@@@           
                   %@@@@@@@@@@@@@%%@@@@@@@@@@@@@@@@@@@@@@@@@@@@@@@@@@@@@@@@@@@@@@@@@%             
                     ##  %@@@@@@%  #@@@@@@@@@@@@@@@@@@@@@@@@@@@@@@@@@@@@@@@@@@%   ###             
                                   @@@@@@@@@@@@@@@@@@@@@@@@@@@@@@@@%@@@%@@%                       
                                     %%%#@@@@@@@@@@@@@@@@@@@@@@@@@%                               
                                          @@@@@@@@@%#@@@@@@@@@@@@%                                
                                          @@@@@@      %@@@@@@@%                                   
                                          %%                    

