
                                                                                        @@@@@@@%      
                                                                                     @@@@@@@@@@@@@@@@@
                                                                                @@@@@@@@@@@@@@@@@@@@@@
                                                                     @@@@@%%@@@@@@@@@@@@@@@@@@@@@@@@@@
                                                                 @@@@@@@@@@@@@@@@@@@@@@@@@@@@@@@@@@@@ 
                                                               @@@@@@@@@@@@@@@@@@@@@@@@@@@@@@@@@@@@@  
                                                             @@@@@@@@@@@@@@@@@@@@@@@@@@@@@@@@@@       
                                                           %@@@@@@@@@@@@@@@@@@@@@@@@@@@@@@@@%         
                                                          @@@@@@@@@@@@@@@@@@@@@@@@@@@@@@@@@%          
                                                        @@@@@@@@@@@@@@@@@@@@@@@%%%@%@@%               
                                                       %@@@@@@@@@@@@@@@@@@@@@%                        
                                                     @@@@@@@@@@@@@@@@@@@@@@@@                         
                                                    @@@@@@@@@@@@@@@@@@@@@@%                           
                                         @@@@@@@@@@@@@@@@@@@@@@@@@@@@@@@@                             
                                    @@@@@@@@@@@@@@@@@@@@@@@@@@@@@@@@@@@@@                             
                                  @@@@@@@@@@@@@@@@@@@@@@@@@@@@@@@@@@@@@@@                             
                                  @@@@@@@@@@@@@@@@@@@@@@@@@@@@@@@@@@%%                                
                                 @@@@@@@@@@@@@@@@@@@@@@@@@@@@@@@@@@@%                                 
                                 @@@@@@@@@@@@@@@@@@@@@@@@@@@@@@@@@@@                                  
                                 @@@@@@@@@@@@@@@@@@@@@@@@@@@@@@@@@@@                                  
                                 @@@@@@@@@@@@@@@@@@@@@@@@@@@@@@@@@@@                                  
                                 @@@@@@@@@@@@@@@@@@@@@@@@@@@@@@@@@@                                   
                                   @@@@@@@@@@@@@@@@@@@@@@@@@@@@@                                      
                                        @@@@@@@@@@@@@@@@@@@    