                                                                                          :@#       
                                                                                       %@@@@@@@##-  
                                       @@@@@    #    -@@@@@@@@@@  #@@@@@           @@@@@@@@@@@@@@@@ 
                                    :@@@@@@@@@@@@@@@@@@@@@@@@@@@@@@@@@@@@@@@@@@@@@@@@@@@@@@@@@@@@@  
                                     +@@@@@@@@@@@@@@@@@@@@@@@@@@@@@@@@@@@@@@@@@@@@@@@@@@@@@@@@      						                                                   @@@@@@@@@@@@@@@@@@@@@@@@@@@@@@@@@@@@@@@@@@@@@@@@@@@@@@@        
                                     @@@@@@@@@@@@@@@@@@@@@@@@@@@@@@@@@@@@@@@@@@@@@                  
                                     @@@@@@@@@@@@@@@@@@@@@@@@@@@@@@@@@@@@@@@@@@@*                   
                                     @@@@@@@@@@@@@@@@@@@@@@@@@@@@@@@@@@@@@@@@@@                     
                                      @@@@@@@@@@@@@@@@@@@@@@@@@@@@@@@@@@@@@@@@                      
                                      @@@@@@@@@@@@@@@@@@@@@@@@@@@@@@@@@@@@@@@@                      
                                      @@@@@@@@@@@@@@@@@@@@@@@@@@@@@@@@@@@@@                         
                                      @@@@@@@@@@@@@@@@@@@@@@@@@@@@@@@@@@@@                          
                                        @@@@@@@@@@@@@@@@@@@@@@@@@@@@@@@@@@                          
                                      @@@@@@@@@@@@@@@@@@@@@@@@@@@@@@@@@@@%                          
                                    @@@@@@@@@@@@@@@@@@@@@@@@@@@@@@@@@@@@                            
                                     @@@@@@@@@@@@@@@@@@@@@@@@@@@@@@@@@@                             
                                       @@@@@@@@@@@@@@@@@@@@@@@@@@@@@@@                              
                                        @@@@@@@@@@@@@@@@@@@@@@@@@@@@@@@                             
                                         @@@@@@@@@@@@@@@@@@@@@@@@@@@@@@*                            
                                        .@@@@@@@@@@@@@@@@@@@@@@@@@@@@@-                             
                                        @@@@@@@@@@@@@@@@@@@@@@@@@@@@%                               
                                       -@@@@@@@@@@@             #@+                                 
                                        @@@@@@@@@@@.                                                
                                          @@@@@@@@@@                                                
                                           @@@@@@@@@@                                               
                                            #@@@@@@@@                                               
                                             %@@@@@@@                                               
                                                  @@@


