                                                                  
                                 @@@@                                                     ++.   
                                @@@@@@@@@@=                                         @@@@@@@@@@@ 
                                 @@@@@@@@@@                                         @@@@@@@@@@@ 
                                    @@@@@@@@@  *%%+                                 @@@@@@@@@@  
                                    @@@@@@@@@@@@@@@@%=@@                            %@@@@@=@@   
                                    @@@@@@@@@@@@@@@@@@@%                            +@@@@@      
                                     @@@@@@@@@@@@@@@@@@@@@.                  :%@@@@@@@@@@       
                                    @@@@@@@@@@@@@@@@@@@@@@ ::            -#@@@@@@@@@@@@@@       
                                  @@@@@@@@@@@@@@@@@@@@@@@@@@@@@@@@@@@@+=@@@@@@@@@@@@@@@@@       
                                  @@@@@@@@@@@@@@@@@@@@@@@@@@@@@@@@@@@@@@@@@@@@@@@@@@@@@@@       
                                   @@@@@@@@@@@@@@@@@@@@@@@@@@@@@@@@@@@@@@@@@@@@@@@@@@           
                                  @@@@@@@@@@@@@@@@@@@@@@@@@@@@@@@@@@@@@@@@@@@@@@@               
                                   @@@@@@@@@@@@@@@@@@@@@@@@@@@@@ @@@@@@@@@@                     
                                   @@@@@@@@@@@@@@@@@@@@@@@@@@@@@                                
                                    @@@@@@@@@@@@@@@@@@@@@@@@@@@                                 
                                     @@@@@@@@@@@@@@@@@@@@@@@@@@                                 
                                       @@@@@@@@@@@@@@@@@@@@@@                                   
                                       @@@@@@@@@@@@@@@@@@@@@                                    
                                       @@@@@@@@@@@@@@@@@@                                       
                                      @@@@@@@@@@@@@@@@@@                                        
                                      @@@@@@@@@@@@@@@@@@                                        
                                      @@@@@@@@@@@@@@@@@@                                        
                                        @@@@@@@@@@@@@@@@                                        
                                          @@@@@@@@@@@@@@                                        
                                           @@@@@@@@@@@@@                                        
                                            @@@@@@@@@@@                                         
                                                @         

